11111111111111111111
10000000000000000001
10000111000001110001
10000101000001010001
10000111000001110001
10000000000000000001
10000000111000000001
10000000000000000001
11111110000011111111
10000000000000000001
10000000000000000001
10000001000100000001
10000001111100000001
10000000000000000001
11111111111111111111
